--------------------------------------------------------------------------------------------------------------------------------------------------------------------------------------------------------------------------------------------------------------------------------------------------------------------------------------------------------------------
--------------------------------------------------------------------------------------------------------------------------------------------------------------------------------------------------------------------------------------------------------------------------------------------------------------------------------------------------------------------
-------------------------------------------------------------------------------------------------------------------------------------------------------------------------------------------------------------------------------------------------------------------------------------------------------------------------XXXXXXXXXXXXXXXXXXXXXXXXXXXXXX-------------
-------------------------------------------------------------------------------------------------------------------------------------------------------------------------------------------------------------------------------------------------------------------------------------------------------------------------XXXXXXXXXXXXXXXXXXXXXXXXXXXXXX-------------
------------------------------------------------------------------------------------------------------------------------------------------------------------------------------------------------------------------------------------------------------------------------------------------------------E------------------XXXXXXXXXXXXXXXXXXXXXXXXXXXXXX-------------
-------------------XXXX----------XXXXXXXXXXXXXXXX--------------------------------------------------------------------------XX--------XXX--------XXXX---------XX----------------------XXXX------------------------------------------------------------------------------------------XX---------E-SSSSS------------------S-XXXXXXXXXXXXXXXXXXXXXXXXXXXXXX-------------
--------------------------------------------------------------------------------------------------------------------------XXX--------XXX--------XXXX---------XX-------------------------------------------------------------------------------------------------------------------XXX------E-----------------------------XXXXXXXXXXXXXXXXXXXXXXXXXXXXXX-------------
-------------------------------------------------------------------------------------------------------------------------XXXX--------XXX--------XXXX---------XX------------------------------------------------------------------------------------------------------------------XXXX------------------------------------XXXXXXXXXXXXXXXXXXXXXXXXXXXXXX-------------
------------------------------------------------------------------------------------------------------------------------XXXXX--------XXX--------XXXX---------XX-----------------------------------------------------------------------------------------------------------------XXXXX---------------------------------S--XXXXXXXXXXXXXXXXXXXXXXXXXXXXXX-------------
-----QQQQ--------------------------------------------------------------------------------------------------------------XXXXXXS-------XXX--------XXXX---------XX--------------------------------------------------------------------ooo-----------------------------------------XXXXXX------------SSS---------------------XXXXXXXXXXXXXXXXXXXXXXXXXXXXXX-------------
-------------------------------------------------------------------B-------------------E------------------------------XXXXXXX--------XXX--------XXXX---------XX----------------------------------------------------------------------------------------------------------------XXXXXX-------------------------------E----XXXXXXXXXXXXXXXXXXXXXXXXXXXXXX-------------
------------------------------------------------------------------Eb-------------------------------------------------XXXXXXXX--------XXX--------XXXX---------XX---------------B---------------------------E--------------------------------------------------------------------XXXXXX----------------------------------E-XXXXXXXXXXXXXXXXXXXXXXXXXXXXXX-------------
-------------------------------------------------------E-----------BEE---------------------------E-EE---------------XXXXXXXXX--------XXX--------XXXX---------XX---------------b------------------------------------------EE-------------------EE-E------------------EE---X-----XXXXXX------------------------------------XXXXXXXXXXXXXXXXXXXXXXXXXXXXXX-----------X-
XXXXXXXXXXXXXXXXXXXXXXXXX-----XXXXXXXXX--XX--XX--XXXXXXXXXXXXXXXXXXXXXXXXXXXXXXXXXXXXXXXXXXXXXXXXXXXXXXXXXXXXXXXXXXXXXXXXXXXXXX------XXX--------XXXX---------XXXXXXXXX---XXXXXXXXXXXXXXXXXXXXX--XX--XXXXXXXX--XXXXXXXXXXXXXXXXXXXXXXXX--XXXXXXXXXXXXXXXXXXXXXXXXXX--XXXXXX-----XXXXXX----------XXXXXXXXXXXXXXXXXXXXXXXXXXXXXXXXXXXXXXXXXXXXXXXXXXXXXXXX--XXXXXXXXXXX
